F,E,E,E,E,E,E,E,E,E,E,E,E,F,F,F,
F,F,E,T,E,C,E,E,E,E,E,E,E,F,F,F,
F,F,E,F,F,F,F,F,F,F,F,F,E,E,F,F,
F,E,E,E,E,E,E,E,E,E,E,E,E,E,F,F,
F,E,F,F,F,F,F,F,F,F,F,F,F,F,F,F,
F,E,E,E,E,E,E,E,E,E,E,E,E,F,F,F,
F,F,F,F,F,F,F,F,F,F,F,F,E,E,F,F,
F,F,F,F,F,E,F,E,E,E,F,F,F,F,F,F,
F,E,E,E,F,E,E,E,E,E,E,E,F,F,F,F,
F,E,E,E,E,E,E,E,F,F,F,E,E,F,F,F,
F,F,E,E,F,E,E,E,E,E,E,E,E,E,F,F,
F,F,F,F,F,F,F,F,F,F,F,F,F,F,F,F,