F,F,F,F,F,F,F,F,F,F,F,F,F,F,F,F,
F,E,E,E,E,E,E,E,E,E,E,E,E,E,P,F,
F,F,F,E,E,E,E,E,F,F,F,F,F,F,F,F,
F,C,E,F,F,E,E,E,E,E,E,E,E,E,P,F,
F,F,F,F,F,F,F,E,E,E,E,F,F,F,F,F,
F,C,E,F,F,F,F,F,F,E,E,E,E,E,C,F,
F,F,F,F,F,F,F,F,F,F,F,E,E,E,F,F,
F,G,E,E,E,E,E,E,E,E,E,E,E,E,C,F,
F,F,F,F,F,F,E,E,F,F,F,E,E,E,F,F,
F,E,E,E,E,E,E,E,E,E,E,E,E,E,G,F,
F,F,F,F,F,T,E,F,F,F,F,F,E,E,F,F,
F,F,F,F,F,F,F,F,F,F,F,F,F,F,F,F,
