F,F,F,F,F,F,F,F,F,F,F,F,F,F,F,F,
F,E,E,E,E,E,E,E,E,E,E,E,E,E,E,F,
F,P,E,E,E,E,E,E,E,E,G,E,E,E,E,F,
F,F,F,F,E,E,E,F,F,F,F,F,F,F,F,F,
F,C,E,E,E,E,E,E,E,E,E,E,E,E,G,F,
F,F,F,E,E,F,F,F,E,E,F,F,F,F,F,F,
F,E,E,E,E,E,E,E,E,E,E,E,E,E,C,F,
F,F,E,E,F,F,F,E,E,E,F,F,F,F,F,F,
F,E,E,E,E,E,E,E,E,E,E,E,E,E,C,F,
F,F,F,F,F,E,E,E,E,E,F,F,F,F,F,F,
F,E,E,E,E,E,T,E,E,E,E,E,E,E,E,F,
F,F,F,F,F,F,F,F,F,F,F,F,F,F,F,F,
