F,F,F,F,F,F,F,F,F,F,F,F,F,F,F,F,
F,F,F,F,F,F,F,F,E,E,E,E,G,E,E,F,
F,F,F,F,F,F,E,E,E,E,F,F,F,E,E,F,
F,F,F,F,E,E,E,E,E,E,E,E,C,E,E,F,
F,P,E,E,E,E,E,F,F,F,F,F,F,E,E,F,
F,F,F,E,E,E,E,E,E,E,E,E,C,E,E,F,
F,F,F,F,F,E,E,E,F,F,F,F,F,E,E,F,
F,E,E,E,E,E,E,F,F,E,E,E,E,E,C,F,
F,T,E,E,E,E,F,F,E,E,E,E,F,F,F,F,
F,F,F,F,E,E,E,E,E,E,F,F,F,F,F,F,
F,F,F,F,F,E,E,E,F,F,F,F,F,F,F,F,
F,F,F,F,F,F,F,F,F,F,F,F,F,F,F,F,
