F,F,F,F,F,F,F,F,F,F,F,F,F,F,F,F,
F,F,F,F,F,F,F,F,E,E,E,E,E,E,E,F,
F,F,E,E,E,F,E,E,E,E,F,F,F,E,E,F,
F,F,F,F,E,E,E,E,E,E,E,E,E,E,E,F,
F,E,E,E,E,E,E,F,F,E,F,F,F,E,E,F,
F,F,F,E,E,E,E,E,E,E,E,E,E,E,E,F,
F,F,F,F,F,E,E,E,F,F,F,F,F,E,E,F,
F,F,F,E,E,E,E,F,F,E,E,E,E,E,E,F,
F,T,E,E,E,E,F,E,E,P,E,P,F,F,F,F,
F,F,F,F,E,E,E,E,E,E,F,F,F,F,F,F,
F,F,F,F,F,P,E,E,F,F,F,F,F,F,F,F,
F,F,F,F,F,F,F,F,F,F,F,F,F,F,F,F,
