F,F,F,F,F,F,F,F,F,F,F,F,F,F,F,F,
F,P,E,E,E,E,E,E,E,E,E,E,E,E,P,F,
F,F,F,F,E,E,F,F,F,F,E,E,F,F,F,F,
F,G,E,E,E,E,E,E,E,E,E,E,E,E,G,F,
F,F,F,F,F,E,E,F,F,E,E,F,F,F,F,F,
F,E,E,E,E,E,E,C,E,E,E,E,E,E,E,F,
F,E,E,F,F,F,F,F,F,F,F,F,F,E,E,F,
F,E,E,E,E,E,E,E,E,E,E,E,E,E,E,F,
F,F,F,E,E,E,E,F,F,E,E,E,E,F,F,F,
F,F,F,F,E,E,E,E,T,E,E,E,F,F,F,F,
F,F,F,F,F,E,E,F,F,E,E,F,F,F,F,F,
F,F,F,F,F,F,F,F,F,F,F,F,F,F,F,F,
