F,F,F,F,F,F,F,F,F,F,F,F,F,F,F,F,
F,G,E,E,E,E,E,E,E,P,E,E,E,E,G,F,
F,F,F,E,E,E,E,E,F,F,F,F,E,E,F,F,
F,F,F,F,F,E,E,E,E,E,E,E,E,E,E,F,
F,E,E,E,E,E,E,F,F,F,F,F,E,E,F,F,
F,E,E,E,E,F,F,F,F,C,E,E,E,E,E,F,
F,E,E,F,F,F,F,F,F,F,F,F,E,E,F,F,
F,C,E,E,E,E,E,E,E,E,E,E,E,E,E,F,
F,F,F,F,E,E,E,E,F,F,F,E,E,E,F,F,
F,F,F,F,F,F,E,E,E,E,E,E,E,F,F,F,
F,F,F,F,F,F,F,F,T,E,E,F,F,F,F,F,
F,F,F,F,F,F,F,F,F,F,F,F,F,F,F,F,
