F,F,F,F,F,F,F,F,F,F,F,F,F,F,F,F,
F,E,E,F,F,F,E,E,F,F,F,E,E,F,F,F,
F,G,E,E,E,E,E,E,E,E,E,E,E,E,C,F,
F,F,F,E,E,F,F,E,E,F,F,E,E,F,F,F,
F,E,E,E,E,E,E,E,E,E,E,E,E,E,C,F,
F,E,E,F,F,F,E,E,F,F,F,E,E,F,F,F,
F,G,E,E,E,E,E,E,E,E,E,E,E,E,C,F,
F,F,F,E,E,F,F,E,E,F,F,E,E,F,F,F,
F,E,E,E,E,E,E,E,E,E,E,E,E,E,E,F,
F,E,E,F,F,F,E,E,F,F,F,E,E,F,F,F,
F,E,E,E,E,E,E,T,E,E,E,E,E,E,E,F,
F,F,F,F,F,F,F,F,F,F,F,F,F,F,F,F,
