F,F,F,F,F,F,F,F,F,F,F,F,F,F,F,F,
F,E,E,E,E,E,E,E,E,E,E,E,E,E,E,F,
F,E,P,E,E,E,E,E,E,E,E,E,E,G,E,F,
F,F,F,E,E,F,F,E,E,F,F,E,E,F,F,F,
F,E,E,E,E,E,E,G,E,E,E,E,E,E,E,F,
F,E,E,F,F,F,F,F,F,F,F,F,F,E,E,F,
F,E,E,E,E,E,E,E,E,E,E,E,E,E,E,F,
F,F,F,F,E,E,F,F,F,F,E,E,E,F,F,F,
F,E,E,E,E,E,E,E,E,E,E,E,E,E,C,F,
F,F,E,E,E,E,F,F,F,F,F,F,F,F,F,F,
F,F,F,F,T,E,E,E,E,E,E,E,C,F,F,F,
F,F,F,F,F,F,F,F,F,F,F,F,F,F,F,F,
