F,F,F,F,F,F,F,F,F,F,F,F,F,F,F,F,
F,G,E,E,E,E,E,E,P,E,E,E,E,E,G,F,
F,F,F,F,E,E,E,F,F,E,E,E,F,F,F,F,
F,E,E,E,E,E,F,E,E,F,E,E,E,E,E,F,
F,F,E,E,E,F,E,E,E,E,F,E,E,E,F,F,
F,E,E,E,F,E,E,C,C,E,E,F,E,E,E,F,
F,F,E,E,F,F,F,F,F,F,F,F,E,E,F,F,
F,E,E,E,E,E,E,E,E,E,E,E,E,E,E,F,
F,F,F,F,F,E,E,E,E,E,E,F,F,F,F,F,
F,E,E,E,E,E,E,T,E,E,E,E,E,E,E,F,
F,E,E,F,F,F,F,F,F,F,F,F,F,E,C,F,
F,F,F,F,F,F,F,F,F,F,F,F,F,F,F,F,
