F,F,F,F,F,F,F,F,F,F,F,F,F,F,F,F,
F,C,E,E,E,E,E,E,E,E,E,E,E,E,E,F,
F,F,F,F,F,F,E,E,F,F,F,F,F,E,E,F,
F,C,E,E,E,E,E,E,E,E,E,E,E,E,G,F,
F,F,E,E,F,F,E,E,E,E,F,F,E,E,F,F,
F,C,E,E,E,E,F,P,P,F,E,E,E,E,G,F,
F,F,E,E,E,E,E,F,F,E,E,E,E,E,F,F,
F,F,F,F,F,E,E,E,E,E,E,F,F,F,F,F,
F,E,E,E,F,E,E,F,F,E,E,F,E,E,G,F,
F,F,F,F,F,E,E,E,E,E,E,F,F,F,F,F,
F,E,E,E,E,E,T,F,F,E,E,E,E,E,E,F,
F,F,F,F,F,F,F,F,F,F,F,F,F,F,F,F,
