F,E,E,E,E,E,E,E,E,E,E,E,E,F,F,F,
F,F,T,E,E,E,E,e,E,E,E,E,E,F,F,F,
F,F,F,F,F,F,F,F,F,F,F,E,E,F,G,F,
F,F,F,E,E,E,E,E,E,E,E,E,E,E,F,F,
F,E,E,E,F,F,F,F,F,F,F,F,F,F,F,F,
F,E,E,F,F,F,F,F,F,F,F,F,F,F,F,F,
F,E,E,E,E,E,E,E,E,E,E,E,E,F,F,F,
F,F,F,F,F,E,F,E,E,E,F,F,F,F,F,F,
F,E,E,E,E,E,E,E,E,E,E,E,F,F,F,F,
F,E,E,E,F,F,E,F,F,F,F,E,E,F,F,F,
F,F,P,E,F,F,C,E,E,E,E,E,E,E,F,F,
F,F,F,F,F,F,F,F,F,F,F,F,F,F,F,F,