F,E,E,E,E,E,E,E,E,E,E,E,E,F,F,F,
F,F,P,E,E,E,E,T,E,E,E,E,E,F,F,F,
F,F,F,F,F,F,F,F,F,F,F,F,E,F,G,F,
F,F,F,E,E,E,E,E,E,E,E,E,E,E,F,F,
F,E,E,E,F,F,F,F,F,F,F,F,F,F,F,F,
F,E,E,F,F,F,F,F,F,F,F,F,F,F,F,F,
F,E,E,E,E,E,E,E,E,E,E,E,E,F,F,F,
F,F,F,F,F,E,F,E,E,E,F,F,F,F,F,F,
F,E,E,E,E,E,E,E,E,E,E,E,F,F,F,F,
F,E,e,E,F,E,E,F,F,F,F,E,E,F,F,F,
F,F,E,E,F,E,E,E,E,E,E,E,E,E,F,F,
F,F,F,F,F,F,F,F,F,F,F,F,F,F,F,F,