F,E,E,E,E,E,E,E,E,E,E,E,E,F,F,F,
F,F,e,E,E,E,E,e,E,E,E,E,E,F,F,F,
F,E,E,E,E,E,E,E,E,E,E,E,E,E,F,F,
F,F,F,F,F,F,F,F,F,F,F,F,F,F,F,F,
F,E,E,E,F,F,F,F,F,F,F,F,F,F,F,F,
F,E,E,F,F,F,F,F,F,F,F,F,F,F,F,F,
F,E,E,E,E,E,E,E,E,E,E,E,E,F,F,F,
F,F,F,F,F,E,F,E,E,E,F,F,F,F,F,F,
F,E,E,E,E,E,E,E,E,E,E,E,F,F,F,F,
F,E,E,E,F,F,E,F,F,F,F,E,E,F,F,F,
F,F,E,E,F,F,G,E,E,E,E,E,T,E,F,F,
F,F,F,F,F,F,F,F,F,F,F,F,F,F,F,F,