F,E,E,E,E,E,E,E,E,E,E,E,E,E,E,F,
F,F,E,T,E,E,E,E,E,E,E,E,E,E,F,F,
F,F,F,F,F,F,F,F,F,F,F,F,E,F,F,F,
F,F,F,E,E,E,E,E,E,E,E,E,E,E,F,F,
F,E,E,E,F,F,F,F,F,F,F,F,F,F,F,F,
F,E,E,F,F,F,F,F,F,F,F,F,F,F,F,F,
F,E,E,E,E,E,E,E,E,E,E,E,E,F,F,F,
F,F,F,F,F,E,F,E,E,E,F,F,F,F,F,F,
F,E,E,E,E,E,E,E,E,E,E,E,F,F,F,F,
F,E,E,E,F,F,E,F,F,F,F,E,E,F,F,F,
F,F,P,E,F,F,E,E,E,E,E,E,E,E,F,F,
F,F,F,F,F,F,F,F,F,F,F,F,F,F,F,F,