F,E,E,E,E,E,E,E,E,E,E,E,E,E,E,F,
F,E,E,E,E,E,E,E,E,E,E,E,E,E,E,F,
F,F,F,F,F,F,F,F,F,F,F,E,E,E,F,F,
F,F,E,E,E,F,F,F,F,F,F,E,E,E,F,F,
F,F,F,E,E,E,E,E,E,E,E,E,E,F,F,F,
F,F,F,F,E,P,E,F,F,F,E,E,E,F,F,F,
F,F,F,F,E,C,E,F,F,E,F,E,F,F,F,F,
F,F,F,F,E,E,E,E,E,E,E,E,E,F,E,F,
F,E,E,E,E,E,E,E,E,E,E,E,F,F,F,F,
F,F,E,E,F,E,E,E,E,E,E,E,F,F,F,F,
F,F,E,E,E,E,E,E,E,E,E,E,F,T,F,F,
F,F,F,F,F,F,F,F,F,F,F,F,F,F,F,F,