F,C,E,T,E,E,E,E,E,E,E,E,E,E,E,F
F,F,F,F,E,E,E,E,E,E,E,E,E,E,C,F
F,F,F,F,F,E,F,F,F,F,F,F,E,E,F,F
F,F,E,E,E,F,F,F,E,F,F,E,E,E,E,F
F,E,E,E,E,E,E,E,E,E,E,E,E,F,E,F
F,E,F,F,F,F,F,F,F,F,E,E,E,E,F,F
F,E,E,E,E,E,E,E,F,E,F,E,E,F,E,F
F,F,F,F,F,F,F,F,E,E,E,E,E,E,E,F
F,E,E,E,E,E,E,F,E,E,F,E,E,F,F,F
F,F,E,E,E,E,E,E,E,E,E,E,E,F,F,F
F,F,E,G,E,P,E,F,E,E,E,E,E,E,F,F
F,F,F,F,F,F,F,F,F,F,F,F,F,F,F,F