F,E,E,E,E,E,E,E,E,E,E,E,E,E,E,F,
F,E,E,P,E,E,E,E,E,E,E,E,E,E,E,F,
F,F,F,F,F,F,F,F,F,F,F,E,E,E,F,F,
F,F,E,E,E,F,F,F,F,F,F,E,E,E,F,F,
F,F,F,E,E,E,E,E,E,E,E,E,E,F,F,F,
F,F,F,F,E,E,F,F,F,E,E,E,E,F,F,F,
F,F,F,F,E,E,E,F,F,F,E,E,F,F,F,F,
F,F,F,F,E,E,E,E,E,E,E,E,E,F,E,F,
F,E,E,E,E,E,E,E,E,E,E,E,F,F,F,F,
F,F,E,E,F,E,E,E,E,E,E,E,E,F,F,F,
F,F,E,E,E,E,E,E,E,E,T,E,E,E,F,F,
F,F,F,F,F,F,F,F,F,F,F,F,F,F,F,F,