F,E,E,E,E,E,E,E,E,E,E,E,E,F,F,F,
F,F,E,E,E,E,E,E,E,E,E,E,E,F,F,F,
F,F,F,F,F,F,F,F,F,F,F,F,E,E,F,F,
F,E,E,E,E,E,E,E,E,E,E,E,E,E,F,F,
F,E,E,E,F,F,F,F,F,F,F,F,F,F,F,F,
F,E,E,E,E,E,E,E,E,E,E,E,E,F,F,F,
F,F,F,F,F,F,F,F,F,F,F,F,E,E,F,F,
F,F,F,F,F,E,F,E,E,E,F,F,F,F,F,F,
F,E,E,E,F,E,E,E,E,E,E,E,F,F,F,F,
F,E,E,E,E,E,E,E,F,F,F,E,E,F,F,F,
F,F,E,T,F,E,E,P,E,E,E,E,E,E,F,F,
F,F,F,F,F,F,F,F,F,F,F,F,F,F,F,F,