F,E,F,E,E,E,E,E,E,E,E,E,E,E,E,F
F,P,F,E,E,E,E,E,E,E,E,E,E,E,E,F
F,F,F,F,F,E,F,F,F,F,F,F,E,E,F,F
F,F,E,E,E,F,F,F,E,F,F,E,E,E,E,F
F,F,E,E,E,E,E,E,E,E,E,E,E,F,E,F
F,F,F,F,F,F,F,F,F,F,E,E,E,E,F,F
F,F,F,F,E,E,E,F,F,E,F,E,E,F,E,F
F,F,F,F,E,E,E,E,E,E,E,E,E,E,E,F
F,E,E,E,E,E,E,F,E,E,F,E,E,F,F,F
F,F,E,E,E,E,E,E,E,E,E,E,E,F,F,F
F,F,C,E,E,E,E,F,E,E,E,E,E,T,F,F
F,F,F,F,F,F,F,F,F,F,F,F,F,F,F,F
